19,19,19,19,19,19,19,19,19,19,19,19,19,19,19,19,19,19,19,19,19,19,19,19,19,
19,19,19,19,1,2,2,3,19,19,19,19,19,19,19,19,19,19,19,19,19,19,19,19,19,
19,19,1,2,21,0,0,20,2,3,19,19,19,19,1,2,2,2,3,19,19,19,19,19,19,
19,1,21,10,11,11,11,11,12,20,3,19,19,1,21,10,11,12,20,3,19,19,19,19,19,
19,4,0,13,14,14,14,14,15,0,6,19,1,21,0,13,14,15,0,20,3,19,19,19,19,
19,4,0,13,14,14,14,14,15,22,9,19,4,0,0,16,17,18,0,22,9,19,19,19,19,
19,4,0,13,14,14,14,14,15,6,19,19,4,0,0,0,22,8,8,9,19,19,19,19,19,
19,7,23,16,17,17,17,17,18,6,19,1,21,10,11,12,6,19,19,19,19,19,19,19,19,
19,19,7,23,0,22,8,8,23,20,2,21,0,13,14,15,6,19,1,2,2,3,19,19,19,
19,19,19,7,8,9,19,19,7,23,0,0,0,16,17,18,20,2,21,0,0,20,3,19,19,
19,19,19,19,19,19,19,19,19,7,23,0,22,8,8,8,8,8,23,10,11,12,20,3,19,
19,19,19,19,19,19,19,19,19,19,4,0,6,19,19,19,19,19,4,13,14,15,22,9,19,
19,19,19,19,19,19,19,19,19,19,4,0,6,19,19,19,19,19,4,16,17,18,6,19,19,
19,19,19,19,19,19,19,19,19,19,4,0,6,19,19,19,19,19,7,8,8,8,9,19,19,
19,19,19,19,19,19,19,19,19,1,21,0,20,2,3,19,19,19,19,19,19,19,19,19,19,
19,19,19,19,19,19,19,19,1,21,0,22,8,23,20,3,19,19,19,19,19,19,19,19,19,
19,19,19,19,19,19,19,19,4,0,22,9,19,7,23,20,2,2,2,2,2,2,3,19,19,
19,19,19,1,2,2,2,2,21,22,9,19,19,19,7,23,10,11,11,11,12,0,6,19,19,
19,19,1,21,0,0,22,8,23,6,19,19,19,19,19,4,13,14,14,14,15,0,6,19,19,
19,1,21,0,0,22,9,19,4,6,19,19,19,19,19,4,13,14,14,14,15,0,6,19,19,
19,7,23,0,22,9,19,19,4,20,2,3,19,19,19,4,13,14,14,14,15,0,6,19,19,
19,19,7,8,9,19,19,19,7,23,0,20,2,2,2,21,16,17,17,17,18,22,9,19,19,
19,19,19,19,19,19,19,19,19,7,8,8,8,8,8,8,8,8,8,8,8,9,19,19,19,
19,19,19,19,19,19,19,19,19,19,19,19,19,19,19,19,19,19,19,19,19,19,19,19,19,
19,19,19,19,19,19,19,19,19,19,19,19,19,19,19,19,19,19,19,19,19,19,19,19,19,

