18,18,18,18,18,18,18,18,18,18,18,18,18,18,18,18,18,18,18,18,18,18,18,18,18,
18,18,1,2,2,2,3,18,18,18,18,18,18,18,18,18,18,18,18,18,18,18,18,18,18,
18,18,4,0,0,0,19,2,2,2,3,18,18,18,18,18,1,2,2,2,2,3,18,18,18,
18,18,4,9,10,10,10,11,0,0,5,18,18,18,1,2,20,0,0,0,0,19,3,18,18,
18,1,20,12,13,13,13,14,0,0,19,2,2,2,20,0,9,10,10,10,10,11,19,3,18,
18,4,0,12,13,13,13,14,0,0,0,0,0,0,0,0,12,13,13,13,13,14,0,5,18,
18,4,0,15,16,16,16,17,21,7,7,7,22,0,0,0,12,13,13,13,13,14,0,5,18,
18,4,0,0,0,0,21,7,8,18,18,18,6,22,0,0,12,13,13,13,13,14,0,5,18,
18,6,7,7,7,7,8,18,18,18,18,18,18,4,0,0,12,13,13,13,13,14,21,8,18,
18,18,18,18,18,18,18,18,18,18,18,18,18,6,22,0,15,16,16,16,16,17,5,18,18,
18,18,18,18,18,18,18,18,18,18,18,18,18,18,6,22,0,0,0,0,0,21,8,18,18,
18,18,18,18,18,18,1,2,3,18,18,18,18,18,18,6,22,0,0,0,21,8,18,18,18,
18,18,18,18,18,1,20,0,19,3,18,18,18,18,18,18,6,22,0,21,8,18,18,18,18,
18,18,18,18,1,20,0,0,0,19,2,3,18,18,18,18,18,4,0,5,18,18,18,18,18,
18,18,18,1,20,0,0,0,0,0,0,19,2,3,18,18,18,4,0,5,18,18,18,18,18,
18,18,1,20,9,10,10,10,10,10,10,10,11,19,3,18,18,4,21,8,18,18,18,18,18,
18,18,4,0,12,13,13,13,13,13,13,13,14,0,19,2,2,20,5,18,18,18,18,18,18,
18,18,4,0,12,13,13,13,13,13,13,13,14,9,10,10,11,0,5,18,18,18,18,18,18,
18,18,4,0,12,13,13,13,13,13,13,13,14,12,13,13,14,0,5,18,18,18,18,18,18,
18,18,4,0,12,13,13,13,13,13,13,13,14,15,16,16,17,21,8,18,18,18,18,18,18,
18,18,6,22,15,16,16,16,16,16,16,16,17,0,0,21,7,8,18,18,18,18,18,18,18,
18,18,18,6,7,22,0,0,0,0,0,0,0,21,7,8,18,18,18,18,18,18,18,18,18,
18,18,18,18,18,6,22,0,0,0,21,7,7,8,18,18,18,18,18,18,18,18,18,18,18,
18,18,18,18,18,18,6,7,7,7,8,18,18,18,18,18,18,18,18,18,18,18,18,18,18,
18,18,18,18,18,18,18,18,18,18,18,18,18,18,18,18,18,18,18,18,18,18,18,18,18,

0,0,1,1,1,1,1,0,0,0,0,0,0,0,0,0,0,0,0,0,0,0,0,0,0,
0,1,0,0,0,0,0,1,1,1,1,0,0,0,0,0,1,1,1,1,1,1,0,0,0,
0,1,0,0,0,0,0,0,0,0,0,1,0,0,1,1,0,0,0,0,0,0,1,0,0,
0,1,0,0,0,0,0,0,0,0,0,1,1,1,0,0,0,0,0,0,0,0,0,1,0,
1,0,0,0,0,0,0,0,0,0,0,0,0,0,0,0,0,0,0,0,0,0,0,0,1,
1,0,0,0,0,0,0,0,0,0,0,0,0,0,0,0,0,0,0,0,0,0,0,0,1,
1,0,0,0,0,0,0,0,0,0,0,0,0,0,0,0,0,0,0,0,0,0,0,0,1,
1,0,0,0,0,0,0,0,0,1,1,1,0,0,0,0,0,0,0,0,0,0,0,0,1,
1,0,0,0,0,0,0,1,1,0,0,0,1,0,0,0,0,0,0,0,0,0,0,0,1,
0,1,1,1,1,1,1,0,0,0,0,0,1,0,0,0,0,0,0,0,0,0,0,1,0,
0,0,0,0,0,0,1,1,1,0,0,0,0,1,0,0,0,0,0,0,0,0,0,1,0,
0,0,0,0,0,1,0,0,0,1,0,0,0,0,1,0,0,0,0,0,0,0,1,0,0,
0,0,0,0,1,0,0,0,0,0,1,1,0,0,0,1,0,0,0,0,0,1,0,0,0,
0,0,0,1,0,0,0,0,0,0,0,0,1,1,0,0,1,0,0,0,1,0,0,0,0,
0,0,1,0,0,0,0,0,0,0,0,0,0,0,1,0,1,0,0,0,1,0,0,0,0,
0,1,0,0,0,0,0,0,0,0,0,0,0,0,0,1,1,0,0,0,1,0,0,0,0,
0,1,0,0,0,0,0,0,0,0,0,0,0,0,0,0,0,0,0,1,0,0,0,0,0,
0,1,0,0,0,0,0,0,0,0,0,0,0,0,0,0,0,0,0,1,0,0,0,0,0,
0,1,0,0,0,0,0,0,0,0,0,0,0,0,0,0,0,0,0,1,0,0,0,0,0,
0,1,0,0,0,0,0,0,0,0,0,0,0,0,0,0,0,0,0,1,0,0,0,0,0,
0,1,0,0,0,0,0,0,0,0,0,0,0,0,0,0,0,0,1,0,0,0,0,0,0,
0,0,1,0,0,0,0,0,0,0,0,0,0,0,0,0,1,1,0,0,0,0,0,0,0,
0,0,0,1,1,0,0,0,0,0,0,0,0,0,1,1,0,0,0,0,0,0,0,0,0,
0,0,0,0,0,1,0,0,0,0,0,1,1,1,0,0,0,0,0,0,0,0,0,0,0,
0,0,0,0,0,0,1,1,1,1,1,0,0,0,0,0,0,0,0,0,0,0,0,0,0,

